Lane,SampleID,Index,# Reads,# Perfect Index Reads,# One Mismatch Index Reads,# of >= Q30 Bases (PF),Mean Quality Score (PF)
7,359250488,AAGCGCAT-TTGTCGGT,29854797,28867059,987738,8613773911,39.11
7,359180426,CACTGACA-TTGCGAAG,23441581,21541861,1899720,6746330682,39.03
7,359250481,AGGTCACT-GTGGTGTT,16027930,14859725,1168205,4580405803,38.91
7,359250461,GTCACTGT-GAGATACG,18814753,16583348,2231405,5400829163,39.01
7,359180430,ATGCCAAC-TTCGTACC,16538260,14640303,1897957,4719754020,38.89
7,359250495,CACGTTGT-ATCGATCG,16240807,14971083,1269724,4647896388,38.95
7,359250436,TATTCCGG-GGTGTCTT,14249817,13520839,728978,4054470881,38.78
7,359180384,TGCTTCCA-AGCAGATG,20333248,18748729,1584519,5859660575,39.08
7,359250452,GTCTAGGT-TCTGAGAG,55021185,51400607,3620578,15886907945,39.12
7,359180356,GTTCAACC-TCAGACGA,22746091,21237131,1508960,6511045427,38.95
7,359250498,CGCAATCT-GGCTATTG,16838398,14193132,2645266,4810060760,38.91
7,359250483,TTAAGCGG-GACGAATG,11747628,10463537,1284091,3319010014,38.66
7,359180394,TGCTTGGT-TTGCCACT,19082119,17729084,1353035,5470401908,38.98
7,359180424,ACACACTC-CATACCAC,17106532,13792533,3313999,4902289679,38.97
7,359180346,CCACTTCT-ACAGCTCA,14076093,12475532,1600561,4038669295,38.99
7,359180373,TTGGTCTC-TCTTGACG,11602088,10902568,699520,3348553564,39.10
7,359250407,CTCATCAG-CGATGCTT,31200723,25544186,5656537,8987606496,39.06
7,359250449,ATGACGTC-CTGGAGTA,20114804,16367913,3746891,5782166338,39.02
7,359180421,AACCTTGG-CAGGTATC,13867962,11320080,2547882,3975955469,38.96
7,359180347,GTCTTGCA-GAAGAGGT,18608728,17999460,609268,5313787538,38.90
7,359250447,CAAGTGCA-AAGTCCGT,24430075,22494316,1935759,6931317123,38.79
7,359180402,TCCGAGTT-CACACATG,17690720,15206400,2484320,5096336485,39.07
7,359180395,ACCTAAGG-TTGAGGCA,14832325,14304365,527960,4243797711,38.94
7,359250474,TTGGACGT-GGTCAGAT,11556091,10582935,973156,3333814761,39.10
7,359250416,GATAGCGA-AGTCTGTG,6557283,5761833,795450,1869434562,38.86
7,BLANK1_NPH_1_B,TTGGTGAG-CTACAGTG,1596011,1298413,297598,453838397,38.83
7,359180339,AACTGGTG-TTCCTGTG,22401961,19383085,3018876,6420255053,38.98
7,359250435,TAGCCGAA-GTTCATGG,21644146,20190225,1453921,6217663025,39.01
7,359180358,TGCGAACT-GTATTGGC,12819805,12354131,465674,3660459086,38.89
7,359180409,GACTTAGG-TGGTAGCT,26355936,24976507,1379429,7528144472,38.91
7,359250472,ACACCAGT-GTTCGGTT,28793425,26617432,2175993,8296646569,39.08
7,359180389,CCTGATTG-GTTGCGAT,16547174,14812934,1734240,4777919893,39.11
7,359180377,TTGTGTGC-ACAGCAAC,15859885,14634666,1225219,4547721474,38.98
7,359250454,TACCACAG-GGACTAGA,42609697,37431122,5178575,12278485357,39.07
7,359180378,ATTCGAGG-AGTTCGTC,22610767,21445310,1165457,6428199073,38.82
7,359250410,GCACGTAA-CGTACGAA,16252394,13214619,3037775,4653633630,38.94
7,359250466,GTGTGACA-AAGTGTCG,9597807,9196053,401754,2736196181,38.86
7,BLANK1_NPH_5_F,CTGGTTCT-TAGCGTCT,363815,289566,74249,100237911,38.19
7,359180418,ACTGTGTC-GGTTGTCA,17655655,16872070,783585,5068175890,39.00
7,359180368,CCATACGT-GAAGTACC,14049886,13172204,877682,4029593553,38.99
7,359250421,GGTACTAC-GCATACAG,51620616,44786641,6833975,14872253432,39.08
7,359180412,CAGTCCAA-CTTGTCGA,18463127,14911476,3551651,5280724493,38.93
7,359250456,TCGTAGTC-GATTCAGC,21734791,20852869,881922,6219097447,38.94
7,359250478,TCGAGTGA-GCACAACT,19461278,18149374,1311904,5561309123,38.92
7,359250491,TGTAGCCA-AGTCGACA,7907437,7043792,863645,2214757751,38.51
7,359180350,TGCAGGTA-AGAGCCTT,20311128,18449735,1861393,5804991950,38.92
7,359250439,CTAGGTGA-CTGTTAGG,11042668,8389322,2653346,3164882178,38.95
7,359250434,CTCCATGT-CTCGTCTT,9671845,7881696,1790149,2784023367,39.04
7,359180367,CTTACAGC-CACAAGTC,16996983,14586459,2410524,4891698330,39.03
7,359250460,CGTATTCG-TGGAGTTG,18977926,17732487,1245439,5440666072,38.96
7,359180416,ATTCTGGC-ACGGAACA,16470595,15583492,887103,4729675755,39.00
7,359250469,TACCAGGA-ATAGCGGT,12415743,11879324,536419,3543041341,38.87
7,359250408,TACATCGG-GTCCTAAG,3478987,2983836,495151,969089788,38.41
7,359250464,GTGGTGTT-CGGTCATA,14877759,12164829,2712930,4276114751,39.01
7,359180362,CGCATGAT-CACTAGCT,14964832,12772494,2192338,4305530368,39.04
7,359180379,AGTCGACA-CTTCGTTC,17253785,14626194,2627591,4960271751,39.03
7,BLANK1_NPH_8_A,GTGAGCTT-GTTAGACG,835656,791582,44074,234440837,38.54
7,359180349,GACATTCC-CTCTGGTT,12679625,10024276,2655349,3647038640,39.02
7,359180361,AGTTCGTC-ATAAGGCG,16836176,16172245,663931,4829440600,38.98
7,359250475,TAATGCCG-AGAACGAG,26360639,25160116,1200523,7530229208,38.91
7,359180382,CGACCATT-AGTCTCAC,10479044,8834980,1644064,2957932795,38.67
7,359250457,CTGAAGCT-AGCGTGTT,14227248,12475090,1752158,4075512735,38.94
7,359250433,TTGAGGCA-TCTCTAGG,11561384,10083372,1478012,3331673681,39.06
7,359180375,GATCGAGT-ACCTGGAA,14118346,12357329,1761017,4085303160,39.15
7,359250443,ATACTCCG-AAGGCTGA,18205194,17385568,819626,5211927343,38.93
7,359250405,AAGTCCGT-AGTTGGCT,14901401,14419601,481800,4291359559,39.05
7,359180404,TAGCGTCT-TGAGCTAG,12692818,12164659,528159,3628822041,38.92
7,359180420,TGACGCAT-TCTCTTCC,11189274,10508792,680482,3226619520,39.08
7,359250477,AGCGTGTT-CCAGTGTT,18653111,14936209,3716902,5330323752,38.91
7,BLANK1_NPH_9_F,TGCACCAA-GCGATAGT,546708,513520,33188,149981732,38.10
7,359250438,ATCACACG-GCTGTTGT,11917973,11013510,904463,3414842475,38.94
7,359180365,ATGCCTGT-AAGCCACA,13144546,12004774,1139772,3807317694,39.18
7,359250453,ACCTGACT-CATGGAAC,15916066,13114627,2801439,4576147701,39.02
7,359180392,GCTTCGAA-ACCATCCA,13790882,12748117,1042765,3940467063,38.90
7,BLANK1_NPH_10_D,CGGTCATA-CGTTATGC,1057776,862271,195505,296643998,38.53
7,359250422,GTTAGACG-AGGTTCGA,22726958,21661539,1065419,6484656852,38.88
7,359180391,TCTAACGC-TGGCATGT,18235880,16884990,1350890,5213878813,38.93
7,359180427,ATAGCGGT-GCAAGATC,12409968,11888348,521620,3572732198,39.05
7,359180397,GGACCTAT-CGCTTAAC,13104088,11206245,1897843,3786790163,39.13
7,359250431,CGATGCTT-ACGATGAC,14630255,13374884,1255371,4209458958,39.02
7,359180340,GAGCTTGT-GTGTCTGA,16575583,15806658,768925,4785833351,39.10
7,359250489,GTGAAGTG-CTTAGGAC,12515123,10245460,2269663,3599868313,39.02
7,359180376,GAGTGGTT-CAAGGTCT,12872989,10531503,2341486,3700633757,39.02
7,359250480,TGATACGC-GCATGTCT,17917708,17038281,879427,5102389200,38.85
7,359250413,AGCAGATG-CTCAGCTA,1049435,905421,144014,284048387,37.83
7,359250441,CCAGTGTT-GCTTCGAA,7476207,6668924,807283,2130466211,38.83
7,359250428,ATTCCTCC-AAGCACTG,4510046,3889628,620418,1277858299,38.72
7,359180357,CTAACTCG-TGGCACTA,16128871,14078356,2050515,4646167986,39.04
7,359180423,GATGAGAC-ACTCCATC,6163992,5519558,644434,1760925915,38.90
7,359180381,TCAGGCTT-TAACGAGG,7756507,6790817,965690,2200310174,38.72
7,359180432,GTTCTCGT-TCCAATCG,8150300,7318186,832114,2350298106,39.08
7,359250492,ATCGATCG-TTCGTTGG,12974394,10478492,2495902,3667426134,38.64
7,359250450,CCTCAGTT-GTCCTTCT,10782155,8972645,1809510,3069471146,38.78
7,BLANK1_NPH_12_G,ACTGCTAG-AACGGTCA,77039,68688,8351,17223745,34.49
7,359250409,TCCGTGAA-TCTAACGC,13221350,12446115,775235,3783450503,38.92
7,359180364,GGATTCGT-CTCCTAGA,11713558,9361935,2351623,3356307162,38.94
7,359180370,GGTCAGAT-CCTATACC,11790822,9498958,2291864,3315020354,38.58
7,359250455,TCGTGGAT-TGATCGGA,14210943,13600285,610658,4067737441,38.93
7,359250499,CGTGTGTA-TTAGGTCG,8300101,7527309,772792,2352717378,38.73
7,359180425,GTGTCTGA-GAGATGTC,8028086,7582369,445717,2283112968,38.79
7,359180407,GAATCGTG-GATACTGG,12766801,12113256,653545,3650150913,38.90
7,359180396,GCGATAGT-AGAAGCGT,14629382,13983238,646144,4179514773,38.90
7,359180380,GGCTATTG-TGTGCGTT,14115605,13420789,694816,4034648800,38.89
7,359180398,AGTTACGG-CGTGATCA,20823672,17094319,3729353,5975091146,38.97
7,359250432,CGTACGAA-TGATACGC,13738158,12720027,1018131,3890297905,38.71
7,359180428,ACCACGAT-AAGGACAC,14913690,13767194,1146496,4289051661,39.02
7,359180415,GATTACCG-ACGTTACC,3900023,3626658,273365,1084811794,38.39
7,BLANK2_NPH_2_E,GAGATACG-TTCTCTCG,274002,244066,29936,75055127,38.07
7,359250485,CGACGTTA-CGTCAATG,11075172,9040692,2034480,3148911690,38.78
7,359250437,GAGATGTC-TCATCACC,6393355,5877371,515984,1828748355,38.91
7,359250500,GATTGGAG-ACACGGTT,9292552,8419336,873216,2653908853,38.90
7,359180353,GCAATTCG-CCAATAGG,2527859,2023261,504598,691965332,38.06
7,359180414,CGTCAATG-CCTACTGA,14342673,11735928,2606745,4127272813,39.03
7,359250419,ATGCACGA-ACCGCATA,2606881,2321761,285120,714282265,38.08
7,359250484,ATCGCCAT-CTAGGCAT,12574706,10322187,2252519,3614674944,39.02
7,359250414,TCTCGCAA-ACTGCTAG,19534514,18154560,1379954,5574994031,38.87
7,359180354,ACGACAGA-GTTGACCT,9072207,8252259,819948,2604025396,38.97
7,359180401,TTACGGCT-TCACGTTC,11098435,9648738,1449697,3187264257,39.00
7,359250411,GAGGACTT-CGCATGAT,8584957,7387336,1197621,2472989540,39.06
7,359180429,GGCATACT-ACTCGTTG,1090288,943814,146474,310522335,38.83
7,359250486,CGTAGGTT-ACATTGCG,9606030,8473284,1132746,2754295090,38.96
7,359180337,ATATGCGC-GCCTTGTT,12198621,9954439,2244182,3494475374,38.95
7,359250424,GGATGTAG-GACATGGT,12739426,11157017,1582409,3659656136,39.01
7,359250448,CCTGTCAT-GCTGGATT,11341468,10461843,879625,3275685248,39.11
7,359180431,TGCTCATG-CGTTGCAA,13876741,11334191,2542550,3984479193,38.98
7,359250467,TGAAGACG-TCGAAGGT,13118122,11855987,1262135,3738114048,38.84
7,359180372,GTTACGCA-TCCGTATG,0,0,0,0,0.00
7,359250482,ACTCAGAC-TATCGGTC,0,0,0,0,0.00
7,359180417,GTCCACAT-ACCAGCTT,0,0,0,0,0.00
7,359180408,CGCTAGTA-TGAGGTGT,12914179,12220309,693870,3690560674,38.89
7,359180399,GAATCCGA-ATACTCCG,2189885,2003335,186550,611613599,38.45
7,359180386,GAGACGAT-AAGTCGAG,14589022,13461651,1127371,4186244372,38.98
7,359250476,TAAGTGGC-TCGTGGAT,5393955,5078633,315322,1532766467,38.77
7,359180413,ACTGAGGT-CGAACTGT,9485119,7697820,1787299,2718733445,38.95
7,359180355,TGTACCGT-CGTCTTGT,10015225,8410078,1605147,2860228553,38.88
7,359250496,AGCAAGCA-ACCACGAT,16479694,15444664,1035030,4727093683,38.96
7,359250479,TCTCGTGT-ACCTGACT,2,0,2,92,21.59
7,359250418,CAAGGTCT-GGTTGATG,1,0,1,266,37.30
7,359250412,TAGACGTG-TAGTGACC,0,0,0,0,0.00
7,359250463,TGAGCTAG-TAATGCCG,0,0,0,0,0.00
7,359250468,CTGACACA-GATCGAGT,0,0,0,0,0.00
7,359250445,ACGGTCTT-GGACCTAT,10618755,9421540,1197215,3053215944,39.01
7,359250473,GCTGTTGT-TGTGACTG,5778700,4943784,834916,1640970692,38.77
7,359250471,CACTAGCT-CACCACTA,10939642,9286915,1652727,3159227490,39.11
7,359180405,TGGTACAG-TTCAGGAG,18062914,16004698,2058216,5208014966,39.07
7,359180338,AGCACTTC-CAGCGATT,10250497,8390276,1860221,2923688482,38.86
7,359180359,GCATACAG-GCCTATCA,10321377,9053243,1268134,2930842272,38.77
7,359250415,CTTAGGAC-TGACGCAT,13839013,11917306,1921707,3966018695,38.97
7,359180410,GCTTCTTG-GTATGCTG,2456726,2239074,217652,680798657,38.29
7,359180383,ACGTTACC-CTGCACTT,0,0,0,0,0.00
7,359250426,CTGTGTTG-CGGAATAC,0,0,0,0,0.00
7,359180371,TGAGGTGT-TGGATCAC,0,0,0,0,0.00
7,359180345,GATCCATG-GTGCCATA,0,0,0,0,0.00
7,359180374,GCCTATCA-CCTATGGT,0,0,0,0,0.00
7,359180403,AACAACCG-GATTGGAG,9650861,9252502,398359,2747455374,38.83
7,359250425,ACTCGTTG-CCGTATCT,12129770,10030207,2099563,3478741094,38.96
7,BLANK2_NPH_8_F,CCTATGGT-GTCATCGA,526525,430802,95723,145069276,38.19
7,359180360,TGTACACC-AGTGTTGG,10657646,10246315,411331,3056546949,38.95
7,359250440,GTATGCTG-CAGTGAAG,14271398,11694129,2577269,4106904207,39.03
7,359250490,TGATGTCC-GAACATCG,0,0,0,0,0.00
7,BLANK2_NPH_9_B,GTCCTTCT-TAACCGGT,0,0,0,0,0.00
7,359250458,ATAAGGCG-GCTGTAAG,0,0,0,0,0.00
7,359250459,CTTACCTG-AAGAGCCA,0,0,0,0,0.00
7,BLANK2_NPH_9_E,CGTTGCAA-ACGGTCTT,0,0,0,0,0.00
7,359250427,GATTCAGC-TGATGTCC,0,0,0,0,0.00
7,359180411,TCACGTTC-TGCACCAA,5483997,4820912,663085,1547868910,38.65
7,359180388,TGTGCGTT-GAACGCTT,10558223,9475912,1082311,3025055434,38.95
7,359180363,TAGTTGCG-TGGAGAGT,14681744,14043553,638191,4194619735,38.89
7,359250444,AAGAGCCA-GAAGGTTC,10907734,10544575,363159,3125436283,38.94
7,359180387,ACAGCTCA-CATGTTCC,16278897,13588878,2690019,4682448575,39.02
7,359180422,GTTAAGGC-ACATAGGC,12396617,11817898,578719,3537388960,38.87
7,359180369,AAGCCACA-AGTTACGG,15232487,13308125,1924362,4323497284,38.75
7,359250494,ACACGGTT-TTGATCCG,5044724,4671205,373519,1415677980,38.55
7,359250451,CAGCGATT-CAATGTGG,0,0,0,0,0.00
7,359250462,TAGTGACC-CGATAGAG,11742732,9700626,2042106,3371524063,38.99
7,359250497,CGAGACTA-CTGACACA,0,0,0,0,0.00
7,BLANK2_NPH_11_B,GACATGGT-TAGTTGCG,576324,541377,34947,160882729,38.44
7,BLANK2_NPH_11_C,GCATGTCT-GTCTGATC,831969,759974,71995,234232850,38.61
7,359250465,ACTCCATC-AGCGGAAT,11959100,10800804,1158296,3429946684,38.96
7,359180366,TGTGACTG-GGAAGGAT,7707830,7279932,427898,2170377819,38.57
7,359250493,CGAAGAAC-TGTGAAGC,13635830,12990061,645769,3892702677,38.87
7,359250420,GGTGTCTT-AACCGAAG,8556652,7251524,1305128,2443188698,38.87
7,359250446,AAGAAGGC-GATCCATG,4526943,4214494,312449,1283282338,38.74
7,359250470,AGGTTCGA-CTGTTGAC,13203966,10808469,2395497,3800820243,39.04
7,359180385,CATGTTCC-CCGGAATT,22483277,18015796,4467481,6479677885,39.08
7,359250406,GTGCCATA-TATTCGCC,17031428,16160993,870435,4915930838,39.09
7,359180406,CCTTGTAG-AACCTCCT,11292304,9927687,1364617,3252996009,39.05
7,359180419,GCTGGATT-CTCAGAGT,116193700,96947533,19246167,33290736278,38.97
7,359250487,TAACGAGG-AAGAAGGC,3993026,3758838,234188,1126718799,38.62
7,359250442,ATGGTTGC-ATGGTCCA,4918243,4603987,314256,1398215186,38.79
7,359180393,CCTATACC-GACTATGC,300242,256259,43983,73449431,35.95
7,Undetermined,Undetermined,749191924,749191924,0,211650531498,38.68
